12 15
############
  #      ###
# # # ## ###
# # ####
# #      ###
# # #### ###
# #      ###
# ####
#      #####
#### #### ##
#### #### ##
##
##  ## #####
##  ## #####
############
