20 20
####################
# #      ###########
# # # ## ###########
# # ####          ##
# #      ########
# # #### ######## ##
# #    # ### #### ##
# #### # ###      ##
#      #   ### ## ##
###### ### ### ## ##
## ### ###   # ## ##
   #   ### # # ## ##
## ### ### # # ## ##
## ### ### #   ## ##
##     ### ###### ##
## ### ### ###### ##
## ###     ###### ##
## #### ##
## ###  ############
##     #############
