12 15
############
  #      ###
# # # ## ###
# # ####
# #      ###
# # #### ###
# #      ###
# ######
#      #####
#### #### ##
#### #### ##
###    #
###### #####
###### #####
############
